8 10
aW000A00
00W00WG0
WDWW0WWW
000000Wd
WWWBWW00
W0000000
00W000WW
bWWCWW0c
WW00W00W
S0000000